agent_id,cumu_time_in_sec,time_index,time_index_t,time_index_diff,travel_time_in_sec,timestamp_minute,from_node_id,to_node_id,length,FFTT_in_sec,delay_in_sec,cumu_distance,label_cost,hh,mm,ss,geometry,geometry_from_node,
6,0,0,4,4,12,16.67,402,131,175.134588,16,-4,175.134583,0.000074,0,16,39,"LINESTRING (-111.938158 33.415000,-111.938552 33.415188,-111.938839 33.415386,-111.939155 33.415634,-111.939396 33.415918,-111.939442 33.415993,-111.939492 33.416074,)","POINT (-111.938158 33.415000)",
6,12,4,6,2,6,16.87,131,132,112.279051,10,-4,287.413635,0.000078,0,16,52,"LINESTRING (-111.939492 33.416074,-111.939605 33.416256,-111.939747 33.416566,-111.939825 33.416902,-111.939837 33.417032,)","POINT (-111.939492 33.416074)",
6,18,6,9,3,9,16.97,132,133,47.002528,6,3,334.416168,0.000114,0,16,57,"LINESTRING (-111.939837 33.417032,-111.939846 33.417120,-111.939844 33.417455,)","POINT (-111.939837 33.417032)",
6,27,9,10,1,3,17.12,133,134,18.237954,6,-3,352.654114,0.000668,0,17,7,"LINESTRING (-111.939844 33.417455,-111.939847 33.417619,)","POINT (-111.939844 33.417455)",
6,30,10,16,6,18,17.17,134,201,118.892810,10,8,471.546936,0.000689,0,17,9,"LINESTRING (-111.939847 33.417619,-111.939846 33.418438,-111.939850 33.418688,)","POINT (-111.939847 33.417619)",
6,48,16,28,12,36,17.47,201,202,5.470861,6,30,477.017792,0.001206,0,17,27,"LINESTRING (-111.939850 33.418688,-111.939851 33.418737,)","POINT (-111.939850 33.418688)",
6,84,28,30,2,6,18.07,202,135,35.608079,6,0,512.625854,0.001233,0,18,3,"LINESTRING (-111.939851 33.418737,-111.939852 33.418984,-111.939854 33.419058,)","POINT (-111.939851 33.418737)",
6,90,30,31,1,3,18.17,135,203,31.042032,6,-3,543.667908,0.001496,0,18,9,"LINESTRING (-111.939854 33.419058,-111.939857 33.419139,-111.939861 33.419337,)","POINT (-111.939854 33.419058)",
6,93,31,32,1,3,18.22,203,205,24.156932,6,-3,567.824829,0.001938,0,18,12,"LINESTRING (-111.939861 33.419337,-111.939866 33.419554,)","POINT (-111.939861 33.419337)",
6,96,32,33,1,3,18.27,205,206,24.818818,6,-3,592.643677,0.002392,0,18,15,"LINESTRING (-111.939866 33.419554,-111.939866 33.419569,-111.939866 33.419777,)","POINT (-111.939866 33.419554)",
6,99,33,35,2,6,18.32,206,207,26.536383,6,0,619.180054,0.002721,0,18,18,"LINESTRING (-111.939866 33.419777,-111.939872 33.420016,)","POINT (-111.939866 33.419777)",
6,105,35,46,11,33,18.42,207,208,24.532705,6,27,643.712769,0.003570,0,18,24,"LINESTRING (-111.939872 33.420016,-111.939881 33.420236,)","POINT (-111.939872 33.420016)",
6,138,46,47,1,3,18.97,208,136,28.288940,6,-3,672.001709,0.004857,0,18,57,"LINESTRING (-111.939881 33.420236,-111.939879 33.420405,-111.939883 33.420490,)","POINT (-111.939881 33.420236)",
6,141,47,57,10,30,19.02,136,209,75.534706,9,21,747.536438,0.005376,0,19,0,"LINESTRING (-111.939883 33.420490,-111.939887 33.420583,-111.939894 33.420960,-111.939894 33.421170,)","POINT (-111.939883 33.420490)",
6,171,57,58,1,3,19.52,209,210,13.310968,6,-3,760.847412,0.005954,0,19,30,"LINESTRING (-111.939894 33.421170,-111.939896 33.421289,)","POINT (-111.939894 33.421170)",
6,174,58,60,2,6,19.57,210,183,67.402867,8,-2,828.250305,0.005983,0,19,33,"LINESTRING (-111.939896 33.421289,-111.939884 33.421479,-111.939905 33.421785,-111.939894 33.421894,)","POINT (-111.939896 33.421289)",
6,180,60,63,3,9,19.67,183,184,9.766884,6,3,838.017212,0.006340,0,19,39,"LINESTRING (-111.939894 33.421894,-111.939897 33.421982,)","POINT (-111.939894 33.421894)",
6,189,63,66,3,9,19.82,184,217,112.094951,13,-4,950.112183,0.006361,0,19,48,"LINESTRING (-111.939897 33.421982,-111.939910 33.422072,-111.939914 33.422407,-111.939963 33.422988,)","POINT (-111.939897 33.421982)",
6,198,66,67,1,3,19.97,217,137,22.310723,6,-3,972.422913,0.006374,0,19,57,"LINESTRING (-111.939963 33.422988,-111.939969 33.423189,)","POINT (-111.939963 33.422988)",
6,201,67,72,5,15,20.02,137,213,91.518138,10,5,1063.941040,0.006400,0,20,0,"LINESTRING (-111.939969 33.423189,-111.939961 33.423904,-111.939959 33.424012,)","POINT (-111.939969 33.423189)",
6,216,72,73,1,3,20.27,213,138,37.055060,6,-3,1100.996094,0.007871,0,20,15,"LINESTRING (-111.939959 33.424012,-111.939952 33.424345,)","POINT (-111.939959 33.424012)",
6,219,73,75,2,6,20.32,138,215,87.222905,10,-4,1188.218994,0.009760,0,20,18,"LINESTRING (-111.939952 33.424345,-111.939958 33.425129,)","POINT (-111.939952 33.424345)",
6,225,75,76,1,3,20.42,215,139,40.342241,6,-3,1228.561279,0.011393,0,20,24,"LINESTRING (-111.939958 33.425129,-111.939961 33.425492,)","POINT (-111.939958 33.425129)",
6,228,76,79,3,9,20.47,139,218,94.516125,11,-2,1323.077393,0.013921,0,20,27,"LINESTRING (-111.939961 33.425492,-111.939964 33.426342,)","POINT (-111.939961 33.425492)",
6,237,79,80,1,3,20.62,218,140,13.810460,6,-3,1336.887817,0.015177,0,20,37,"LINESTRING (-111.939964 33.426342,-111.939964 33.426466,)","POINT (-111.939964 33.426342)",
6,240,80,83,3,9,20.67,140,219,63.347750,7,2,1400.235596,0.016962,0,20,39,"LINESTRING (-111.939964 33.426466,-111.939964 33.427036,)","POINT (-111.939964 33.426466)",
6,249,83,85,2,6,20.82,219,142,38.829405,6,0,1439.064941,0.017990,0,20,48,"LINESTRING (-111.939964 33.427036,-111.939964 33.427282,-111.939963 33.427385,)","POINT (-111.939964 33.427036)",
6,255,85,86,1,3,20.92,142,143,11.753747,6,-3,1450.818726,0.018664,0,20,54,"LINESTRING (-111.939963 33.427385,-111.939964 33.427491,)","POINT (-111.939963 33.427385)",
6,258,86,87,1,3,20.97,143,144,4.014180,6,-3,1454.832886,0.019264,0,20,58,"LINESTRING (-111.939964 33.427491,-111.939964 33.427527,)","POINT (-111.939964 33.427491)",
6,261,87,89,2,6,21.02,144,221,73.346872,8,-2,1528.179810,0.019331,0,21,0,"LINESTRING (-111.939964 33.427527,-111.939962 33.427579,-111.939962 33.428187,)","POINT (-111.939964 33.427527)",
6,267,89,90,1,3,21.12,221,222,27.198285,6,-3,1555.378052,0.020766,0,21,7,"LINESTRING (-111.939962 33.428187,-111.939962 33.428431,)","POINT (-111.939962 33.428187)",
6,270,90,92,2,6,21.17,222,223,71.758336,8,-2,1627.136353,0.023074,0,21,9,"LINESTRING (-111.939962 33.428431,-111.939992 33.428495,-111.940000 33.428674,-111.939983 33.429071,)","POINT (-111.939962 33.428431)",
6,276,92,95,3,9,21.27,223,224,17.302351,6,3,1644.438721,0.024693,0,21,15,"LINESTRING (-111.939983 33.429071,-111.939984 33.429227,)","POINT (-111.939983 33.429071)",
6,285,95,109,14,42,21.42,224,145,39.400017,6,36,1683.838745,0.024902,0,21,24,"LINESTRING (-111.939984 33.429227,-111.939996 33.429384,-111.939961 33.429499,-111.939964 33.429577,)","POINT (-111.939984 33.429227)",
